27; 27

###########################
#.....#...................#
#.OOO.#...................#
#.OOO.#...................#
#.OOO.#...................#
#.....#############...#...#
#.....................#...#
#.....................#...#
#.....................#...#
##...##################...#
##.@.##...................#
##...##...................#
#######...................#
#.....#...#################
#.OOO.#.......#...........#
#.OOO.#.......#...........#
#.OOO.#.......#...........#
#.....#####...#...#...#...#
#.........#...#...#...#...#
#.........#.......#...#...#
#.........#.......#...#...#
#.....#...#.......#...#...#
#.....#...#########...#...#
#..@..#...............#...#
#.....#...............#...#
#.....#...............#...#
###########################

000000000000000000000000000
011111000000000000000000000
011111000000000000000000000
011111000000000000000000000
011111000000000000000000000
011111000000000000000000000
000000000000000000000000000
000000000000000000000000000
000000000000000000000000000
001110000000000000000000000
001110000000000000000000000
001110000000000000000000000
000000000000000000000000000
022222000000000000000000000
022222000000000000000000000
022222000000000000000000000
022222000000000000000000000
022222000000000000000000000
000000000000000000000000000
000000000000000000000000000
000000000000000000000000000
022222000000000000000000000
020002000000000000000000000
020202000000000000000000000
020002000000000000000000000
022222000000000000000000000
000000000000000000000000000
