50; 50

##################################################
#........#...................#.............#.....#
#..@.....#...................#.............#..@..#
#........#...................#.............#.....#
#.O.O....#..............######...###########.O.O.#
#........#.....#####...............#.......#.....#
######...#.....#...#...............#.............#
#..............#...#.............................#
#..............#...#...##........................#
#..............#...#.............................#
######...##...##...#........#########....#########
#........#.........#........#....................#
#........#.........##......##....................#
#........#..........#......#.....................#
#...######...##....................#.........#####
#...#........##....................#...###.......#
#...#.............................##...###.......#
#...#.............................#..............#
#...######.......#####....#####...#..........#####
#................#............#...#..........#...#
#................#............#...#..........#...#
#................#............#...#..........#...#
##############...#...##..##...#...#...########...#
#............#.......#....#......................#
#............#...................................#
#............#...................................#
#...#####....#.......#....#.............##########
#...#........#...#...##..##...#.........#...#....#
#...#........#...#............#.........#...#....#
#...#........#...#............#.........#...#....#
#...#........#...#............#.........#...#....#
#...##########...#####....#####...#######...##...#
#............#...................................#
#............#...................................#
#............#...................................#
#...#........#...#..............##################
##########.......................................#
#....#...........................................#
#....#...........................................#
#....#...............######...##...###########...#
#....................#...#.....#...#.............#
#....................#...#.....#...#.............#
#....................#...#.....#...#.............#
##########...#...#...#.........#...#.....#########
#............#...#...#.........#...#.............#
#...O........#...#...#.........#...#.........O...#
#.@..........#.................#...#...........@.#
#...O........#.................#...#.........O...#
#............#.................#...#.............#
##################################################

00000000000000000000000000000000000000000000000000
02222200000000000000000000000000000000000000333330
02222200000000000000000000000000000000000000333330
02222200000000000000000000000000000000000000333330
02222200000000000000000000000000000000000000333330
02222200000000000000000000000000000000000000333330
00000000000000000000000000000000000000000000000000
00000000000000000000000000000000000000000000000000
00000000000000000000000000000000000000000000000000
00000000000000000000000000000000000000000000000000
00000000000000000000000000000000000000000000000000
00000000000000000000000000000000000000000000000000
00000000000000000000000000000000000000000000000000
00000000000000000000000000000000000000000000000000
00000000000000000000000000000000000000000000000000
00000000000000000000000000000000000000000000000000
00000000000000000000000000000000000000000000000000
00000000000000000000000000000000000000000000000000
00000000000000000000000000000000000000000000000000
00000000000000000000000000000000000000000000000000
00000000000000000000000000000000000000000000000000
00000000000000000000000000000000000000000000000000
00000000000000000000000000000000000000000000000000
00000000000000000000000000000000000000000000000000
00000000000000000000000000000000000000000000000000
00000000000000000000000000000000000000000000000000
00000000000000000000000000000000000000000000000000
00000000000000000000000000000000000000000000000000
00000000000000000000000000000000000000000000000000
00000000000000000000000000000000000000000000000000
00000000000000000000000000000000000000000000000000
00000000000000000000000000000000000000000000000000
00000000000000000000000000000000000000000000000000
00000000000000000000000000000000000000000000000000
00000000000000000000000000000000000000000000000000
00000000000000000000000000000000000000000000000000
00000000000000000000000000000000000000000000000000
00000000000000000000000000000000000000000000000000
00000000000000000000000000000000000000000000000000
00000000000000000000000000000000000000000000000000
00000000000000000000000000000000000000000000000000
00000000000000000000000000000000000000000000000000
00000000000000000000000000000000000000000000000000
00000000000000000000000000000000000000000000000000
01111100000000000000000000000000000000000000444440
01111100000000000000000000000000000000000000444440
01111100000000000000000000000000000000000000444440
01111100000000000000000000000000000000000000444440
01111100000000000000000000000000000000000000444440
00000000000000000000000000000000000000000000000000
