26;39

#######################################
###############OOOOOOOOO###############
###############.........###############
###.................................###
###.................................###
###................@................###
###..@..######...........######..@..###
###.....######...........######.....###
###.....######...........######.....###
#.....................................#
#.....................................#
#.....................................#
#...###...##......###......##...###...#
#...###...##......###......##...###...#
#.....................................#
#.....................................#
#.....................................#
###.....######...........######.....###
###.....######...........######.....###
###..@..######...........######..@..###
###................@................###
###.................................###
###.................................###
###############.........###############
###############OOOOOOOOO###############
#######################################

111111111111111111111111111111111111111
111111111111111111111111111111111111111
111111111111111111111111111111111111111
111111111111111111111111111111111111111
111111111111111111111111111111111111111
111111111111111111111111111111111111111
111111111111110000111000011111111111111
111111111111110000000000011111111111111
111111111111110000000000011111111111111
111111111111110000000000011111111111111
111111111111110000000000011111111111111
111111111111110000000000011111111111111
111111111111110000000000011111111111111
222222222222220000000000022222222222222
222222222222220000000000022222222222222
222222222222220000000000022222222222222
222222222222220000000000022222222222222
222222222222220000000000022222222222222
222222222222220000000000022222222222222
222222222222220000222000022222222222222
222222222222222222222222222222222222222
222222222222222222222222222222222222222
222222222222222222222222222222222222222
222222222222222222222222222222222222222
222222222222222222222222222222222222222
222222222222222222222222222222222222222