27; 28

############################
#........#.OOO.#.@.#.......#
#........#.....#...#.......#
#........#.....#...#...#...#
#...@@.....................#
#..........................#
#..........................#
#........#.....#...#...#...#
#...######.....#...#.......#
#..............#...#.......#
#..............#.@.#.......#
#..............#####...#...#
#........#........#........#
#........#........#........#
#........#........#........#
#...#...#####..............#
#.......#.@.#..............#
#.......#...#..............#
#.......#...#.....######...#
#...#...#...#.....#........#
#..........................#
#..........................#
#.....................@@...#
#...#...#...#.....#........#
#.......#...#.....#........#
#.......#.@.#.OOO.#........#
############################

0000000000000000000000000000
0111111110011100111000002220
0111111110000000111000002220
0111111110000000111000002220
0111111111111111111000002220
0111111111111111111000002220
0111111111111111111000002220
0111111110000000111000002220
0111000000000000111000002220
0111000000000000111000002220
0111000000000000111000002220
0111000000000000000000002220
0111000000000000000000002220
0111000000000000000000002220
0111000000000000000000002220
0111000000000000000000002220
0111000002220000000000002220
0111000002220000000000002220
0111000002220000000000002220
0111000002220000000222222220
0111000002222222222222222220
0111000002222222222222222220
0111000002222222222222222220
0111000002220000000222222220
0111000002220000000222222220
0111000002220022200222222220
0000000000000000000000000000
