8; 8

########
#....O@#
#....OO#
#......#
#......#
#OO....#
#@O....#
########

11112222
11112222
11112222
11112222
11112222
11112222
11112222
11112222