14;30

#............................#
#............................#
#............................#
#.....O.......#........O.....#
#.............#..............#
OO..........................OO
OO.@......................@.OO
OO..........................OO
#.............#..............#
#.............#..............#
#.....#................#.....#
#.....#................#.....#
#O..........................O#
#OO........................OO#

111111111111110222222222222222
111111111111110222222222222222
111111111111110222222222222222
111111111111110222222222222222
111111111111100022222222222222
111111111111100022222222222222
111111111111000002222222222222
111111111111100022222222222222
111111111111100022222222222222
111111111111110222222222222222
111111111111110222222222222222
111111111111110222222222222222
111111111111110222222222222222
111111111111110222222222222222