16;32

################################
##............................##
##............................##
##............................##
##.....O.......#........O.....##
##.............#..............##
#OO..........................OO#
#OO.@......................@.OO#
#OO..........................OO#
##.............#..............##
##.............#..............##
##.....#................#.....##
##.....#................#.....##
##O..........................O##
##OO........................OO##
################################

11111111111111102222222222222222
11111111111111102222222222222222
11111111111111102222222222222222
11111111111111102222222222222222
11111111111111102222222222222222
11111111111111000222222222222222
11111111111111000222222222222222
11111111111110000022222222222222
11111111111111000222222222222222
11111111111111000222222222222222
11111111111111102222222222222222
11111111111111102222222222222222
11111111111111102222222222222222
11111111111111102222222222222222
11111111111111102222222222222222
11111111111111102222222222222222