15; 40

########################################
#......................................#
#......................................#
#.O...@..........................@...O.#
#......................................#
#......................................#
#......................................#
#..O..............#..#..............O..#
#.................#..#.................#
#.................#..#.................#
#.................#..#.................#
#.O...@...........#..#...........@...O.#
#......................................#
#......................................#
########################################

1111111111111110000000000222222222222222
1111111111111110000000000222222222222222
1111111111111110000000000222222222222222
1111111111111110000000000222222222222222
1111111111111110000000000222222222222222
1111111111111110000000000222222222222222
1111111111111110000000000222222222222222
1111111111111110000000000222222222222222
1111111111111110000000000222222222222222
1111111111111110000000000222222222222222
1111111111111110000000000222222222222222
1111111111111110000000000222222222222222
1111111111111110000000000222222222222222
1111111111111110000000000222222222222222
1111111111111110000000000222222222222222
