8; 16

################
#...........#O@#
#...........#.O#
#...........####
####...........#
#O.#...........#
#@O#...........#
################

1111111122222222
1111111122222222
1111111122222222
1111111122222222
1111111122222222
1111111122222222
1111111122222222
1111111122222222