16; 8

########
#...OO@#
#...OOO#
#...OOO#
#......#
#......#
#......#
#......#
#......#
#......#
#......#
#......#
#OOO...#
#OOO...#
#@OO...#
########

11112222
11112222
11112222
11112222
11112222
11112222
11112222
11112222
11112222
11112222
11112222
11112222
11112222
11112222
11112222
11112222
11112222