8; 16

################
#...........OO@#
#...........OOO#
#...........OOO#
#OOO...........#
#OOO...........#
#@OO...........#
################

1111111122222222
1111111122222222
1111111122222222
1111111122222222
1111111122222222
1111111122222222
1111111122222222
1111111122222222