23; 27

###########################
#@.......................@#
#...OOO......@......OOO...#
#.........................#
#.........................#
#....####.#.###..######...#
#.........................#
#.........................#
####......................#
#......####.#.#######.....#
#.........................#
#.........................#
#.........................#
#.....######.##.####......#
#......................####
#.........................#
#.........................#
#...######..###.#.####....#
#.........................#
#.........................#
#...OOO......@......OOO...#
#@.......................@#
###########################

000000000000000000000000000
011111111111111111111111110
011111111111111111111111110
011111111111111111111111110
011111111111111111111111110
011111111111111111111111110
011111111111111111111000000
011111111111111111111000000
011111111111111111111000000
000000011111111111111000000
000000000000000000000000000
000000000000000000000000000
000000000000000000000000000
000000222222222222220000000
000000222222222222222222220
000000222222222222222222220
000000222222222222222222220
022222222222222222222222220
022222222222222222222222220
022222222222222222222222220
022222222222222222222222220
022222222222222222222222220
000000000000000000000000000
