9; 9

#########
#OO0..@.#
#.......#
#.......#
#...#...#
#.......#
#.......#
#.@..OOO#
#########

111111111
111111111
000010000
000000000
000000000
000000000
000020000
222222222
222222222