17; 29

#############################
#...O...............#.......#
#.@.O...............#.....@.#
#...O...............#.......#
#.......#####...#.......O...#
#.......#.......#.......O...#
#.......#.......#####.......#
#.........@.....#...........#
#...........#...#...........#
#...........#.....@.........#
#.......#####.......#.......#
#...O.......#.......#.......#
#...O.......#...#####.......#
#.......#...............O...#
#.@.....#...............O.@.#
#.......#...............O...#
#############################

00000000000000000000000000000
01111111000000000000022222220
01111111000000000000022222220
01111111000000000000022222220
01111111000000000000022222220
01111111011110000000022222220
01111111000010000000022222220
01111111101010000222222222220
01111111100000000000222222220
01111111111100002020222222220
01111111000000002000022222220
01111111000000002222022222220
01111111000000000000022222220
01111111000000000000022222220
01111111000000000000022222220
01111111000000000000022222220
00000000000000000000000000000
