33; 13

#############
#.@...O...@.#
#.....O.....#
#.....O.....#
#.@...O...@.#
#.#.......#.#
#.#..###..#.#
#.#.......#.#
#.#.......#.#
#...#...#...#
#...#...#...#
#...#...#...#
#...#...#...#
#.....#.....#
#.#...#...#.#
#.#...#...#.#
#.#...#...#.#
#.#...#...#.#
#.#...#...#.#
#.....#.....#
#...#...#...#
#...#...#...#
#...#...#...#
#...#...#...#
#.#.......#.#
#.#.......#.#
#.#..###..#.#
#.#.......#.#
#.@...O...@.#
#.....O.....#
#.....O.....#
#.@...O...@.#
#############

0000000000000
0111111111110
0111111111110
0111111111110
0111111111110
0000000000000
0000000000000
0000000000000
0000000000000
0000000000000
0000000000000
0000000000000
0000000000000
0000000000000
0000000000000
0000000000000
0000000000000
0000000000000
0000000000000
0000000000000
0000000000000
0000000000000
0000000000000
0000000000000
0000000000000
0000000000000
0000000000000
0000000000000
0222222222220
0222222222220
0222222222220
0222222222220
0000000000000
