8; 16

################
#@00........OO@#
#000........OOO#
#000........OOO#
#..............#
#..............#
#..............#
################

1111111122222222
1111111122222222
1111111122222222
1111111122222222
1111111122222222
1111111122222222
1111111122222222
1111111122222222