8; 16

################
#@OO........OO@#
#OOO........OOO#
#OOO........OOO#
#OOO........OOO#
#OOO........OOO#
#@OO........OO@#
################

1111111122222222
1111111122222222
1111111122222222
1111111122222222
3333333344444444
3333333344444444
3333333344444444
3333333344444444