10; 16

################
#@OO........OO@#
#..............#
#@OO........OO@#
#..............#
#@OO........OO@#
#..............#
#@OO........OO@#
#..............#
################

1111111122222222
1111111122222222
1111111122222222
3333333344444444
3333333344444444
5555555566666666
5555555566666666
7777777788888888
7777777788888888
7777777788888888