8; 16

################
#@OO........OO@#
#OOO........OOO#
#OOO........OOO#
#OOO...........#
#OOO...........#
#@OO...........#
################

1111111122222222
1111111122222222
1111111122222222
1111111122222222
3333333322222222
3333333322222222
3333333322222222
3333333322222222