8; 16

################
#@OO........OO@#
#OOO...#....OOO#
#OOO........OOO#
#......#.......#
#..............#
#......#.......#
################

1111111122222222
1111111122222222
1111111122222222
1111111122222222
1111111122222222
1111111122222222
1111111122222222
1111111122222222