10; 11

###########
#@........#
#.........#
#.........#
#..O...@..#
#.........#
#.........#
###.......#
#O#.......#
###########

11110002222
11110002222
11110002222
11110002222
11110002222
11110002222
11110002222
11110002222
12110002222
11110002222
