35; 35

###################################
#.....................#...........#
#.....................#...........#
#.....................#...........#
#.......##....#...#####...#..###..#
#....O...#..#.#.#.#.......#...#...#
#........#..#.#.#.#.......#...#...#
#........#....#...#.......#...#...#
#...#...@#............#.......#...#
#...######............#......###..#
#...#.......###########.......#...#
#...#.......#.............#...#...#
#...#.......#.............#...#...#
#...#.......#.............#...#...#
#...#...#####..############...#...#
#...........#..#.........#...###..#
#...........#..#.........#........#
#...........#..#.........#........#
#...###..#..#..#.........#........#
#.....#..#..#.......@....#####....#
#....O#..#..#..##........#...#....#
#.....#..#..#............#.O.##...#
#...###..#..#..#.........#........#
#........#..#..#.........#.......##
#........#..#..###########........#
#........#..#......#..............#
#..#######..#......#.......O.##...#
#........#..####...#..#......#....#
#...#....#..#..#...#..#...#####...#
#...#....#.........#..#...#...#...#
#........#.........#..#...#...#...#
#..#######..########..#...........#
#.....................#...........#
#.....................#...........#
###################################

00000000000000000000000000000000000
00000000000000000000000000000000000
00000000000000000000000000000000000
00000000000000000000000000000000000
00000000000000000000000000000000000
00000111100000000000000000000000000
00000111100000000000000000000000000
00000111100000000000000000000000000
00000111100000000000000000000000000
00000000000000000000000000000000000
00000000000000000000000000000000000
00000000000000000000000000000000000
00000000000000000000000000000000000
00000000000000000000000000000000000
00000000000000000000000000000000000
00000000000000002222222220000000000
00000000000000002222222220000000000
00000000000000002222222220000000000
00000000000000002222222220000000000
00001110000000002222222220000000000
00001110000000002222222220222000000
00001110000000002222222220222000000
00000000000000002222222220222000000
00000000000000002222222220222000000
00000000000000000000000000222000000
00000000000000000000000000222000000
00000000000000000000000000222000000
00000000000000000000000000222000000
00000000000000000000000000000000000
00000000000000000000000000011100000
00000000000000000000000000011100000
00000000000000000000000000011100000
00000000000000000000000000000000000
00000000000000000000000000000000000
00000000000000000000000000000000000
