13; 26

##########################
#.....#..................#
#.O.O.#..................#
#.....#.@................#
#.....#..................#
#.....#..................#
#.....##############.....#
#..................#.....#
#..................#.....#
#................@.#.....#
#..................#.O.O.#
#..................#.....#
##########################

00000000000000000000000000
01111101111100000000000000
01111101111100000000000000
01111101111100000000000000
01111101111100000000000000
01111101111100000000000000
00000000000000000000000000
00000000000000222220222220
00000000000000222220222220
00000000000000222220222220
00000000000000222220222220
00000000000000222220222220
00000000000000000000000000
