9; 14

##############
#............#
#.OO.......@.#
#............#
##############
#............#
#.@.......OO.#
#............#
##############

00000000000000
01111000022220
01111000022220
01111000022220
00000000000000
01111000022220
01111000022220
01111000022220
00000000000000
