35; 50

##################################################
#................................................#
#................................................#
#................................................#
#................................................#
#................................................#
#................................................#
#................................................#
#.......@........................................#
#........O.......................................#
#................................................#
#................................................#
#................................................#
#................................................#
#................................................#
#................................................#
#................................................#
#................................................#
#................................................#
#................................................#
#................................................#
#................................................#
#................................................#
#.....................................@..........#
#................................................#
#................................................#
#................................................#
#................................................#
#................................................#
#................................................#
#................................................#
#................................................#
###..............................................#
#O#..............................................#
##################################################

00000000000000000000000000000000000000000000000000
00000000000000000000000000000000000000000000000000
00000000000000000000000000000000000000000000000000
00000000000000000000000000000000000000000000000000
00000000000000000000000000000000000000000000000000
00000000000000000000000000000000000000000000000000
00000000000000000000000000000000000000000000000000
00000001111100000000000000000000000000000000000000
00000001111100000000000000000000000000000000000000
00000001111100000000000000000000000000000000000000
00000001111100000000000000000000000000000000000000
00000001111100000000000000000000000000000000000000
00000000000000000000000000000000000000000000000000
00000000000000000000000000000000000000000000000000
00000000000000000000000000000000000000000000000000
00000000000000000000000000000000002222222222222220
00000000000000000000000000000000002222222222222220
00000000000000000000000000000000002222222222222220
00000000000000000000000000000000002222222222222220
00000000000000000000000000000000002222222222222220
00000000000000000000000000000000002222222222222220
00000000000000000000000000000000002222222222222220
00000000000000000000000000000000002222222222222220
00000000000000000000000000000000002222222222222220
00000000000000000000000000000000002222222222222220
00000000000000000000000000000000002222222222222220
00000000000000000000000000000000002222222222222220
00000000000000000000000000000000002222222222222220
00000000000000000000000000000000002222222222222220
00000000000000000000000000000000002222222222222220
00000000000000000000000000000000002222222222222220
00000000000000000000000000000000002222222222222220
00000000000000000000000000000000000000000000000000
02000000000000000000000000000000000000000000000000
00000000000000000000000000000000000000000000000000
