17; 32

################################
#....#.#....#......#......#....#
#.@@.#O..#....#..#....#...#....#
#....#.....#........#..........#
#.#.##O.#....#.##......#.......#
#....#.....#........#..........#
##.#.#O..#....#..#....#...#.#.##
#....#.#....#......#......#....#
#.#.########################.#.#
#....#.#....#......#....#.#....#
##.#.#...#....#..#....#..O#.#.##
#..........#........#.....#....#
#.......#....#.##.#....#.O##.#.#
#..........#........#.....#....#
#....#...#....#..#....#..O#.@@.#
#....#.#....#......#....#.#....#
################################

00000000000000000000000000000000
01111011000000000000000000000000
01111011000000000000000000000000
01111011000000000000000000000000
00000011000000000000000000000000
00000011000000000000000000000000
00000011000000000000000000000000
00000011000000000000000000000000
00000000000000000000000000000000
00000000000000000000000022000000
00000000000000000000000022000000
00000000000000000000000022000000
00000000000000000000000022000000
00000000000000000000000022022220
00000000000000000000000022022220
00000000000000000000000022022220
00000000000000000000000000000000
