19; 34

##################################
#.....#####################......#
#.....#.#....#......#....#.......#
#..@..#O..#....#..#....#.........#
#.....#.....#........#.......@...#
##...##O.#....#.##.#....#........#
#.....#.....#........#...........#
#.#.#.#O..#....#..#....#.....#.#.#
#.....#.#....#......#....#.......#
##.#.########################.#.##
#.......#....#......#....#.#.....#
#.#.#.....#....#..#....#..O#.#.#.#
#...........#........#.....#.....#
#........#....#.##.#....#.O##...##
#...@.......#........#.....#.....#
#.........#....#..#....#..O#..@..#
#.......#....#......#....#.#.....#
#......#####################.....#
##################################

0000000000000000000000000000000000
0111110110000000000000000000000000
0111110110000000000000000000000000
0111110110000000000000000000222000
0111110110000000000000000000222000
0000000110000000000000000000222000
0000000110000000000000000000000000
0000000110000000000000000000000000
0000000110000000000000000000000000
0000000000000000000000000000000000
0000000000000000000000000220000000
0000000000000000000000000220000000
0000000000000000000000000220000000
0001110000000000000000000220000000
0001110000000000000000000220222220
0001110000000000000000000220222220
0000000000000000000000000220222220
0000000000000000000000000220222220
0000000000000000000000000000000000
