20; 17

#################
#...............#
#...............#
#.......#.......#
#.O.....#.....@.#
#.O.....#.......#
#.......#.......#
#...............#
#...............#
#################
#################
#...............#
#...............#
#.......#.......#
#.......#.....O.#
#.@.....#.....O.#
#.......#.......#
#...............#
#...............#
#################

00000000000000000
01110000000002220
01110000000002220
01110000000002220
01110000000002220
01110000000002220
01110000000002220
01110000000002220
01110000000002220
00000000000000000
00000000000000000
01110000000002220
01110000000002220
01110000000002220
01110000000002220
01110000000002220
01110000000002220
01110000000002220
01110000000002220
00000000000000000
