17; 21

#####################
#....#.........#....#
#.........#.........#
#.O..........#....@.#
#....#..#...........#
#.O.................#
#.........#....#....#
#....#.......#......#
#####################
#......#.......#....#
#....#....#.........#
#.................O.#
#...........#..#....#
#.@....#..........O.#
#.........#.........#
#....#.........#....#
#####################

000000000000000000000
011100000000000002220
011100000000000002220
011100000000000002220
011100000000000002220
011100000000000002220
011100000000000002220
011100000000000002220
000000000000000000000
011100000000000002220
011100000000000002220
011100000000000002220
011100000000000002220
011100000000000002220
011100000000000002220
011100000000000002220
000000000000000000000
