35; 35

###################################
#.................................#
#.O...............................#
#..O..............................#
#....##...#..#......#...#.........#
#....#....#..#......#####....#....#
#....#....#..#......#........#....#
#......@..#..#......#........###..#
#.........#..########........#....#
#.........#..................#....#
#....######..................#....#
#....#...............#...#####....#
#....#...............#...#........#
#...##...............#...#........#
#........###...#######...#........#
#..........#...#.........#...##...#
#..........#...#.............#....#
#...####...#...#.............#....#
#......#...#####.............#....#
#......#............@....#...#....#
#......#.................#...#....#
#......#.................#...##...#
#...#######..............#........#
#.........#..............#........#
#.........#...############........#
#.........#........#.....#........#
#.........#........#.....#...##...#
#...#######........#.....#...#....#
#..................#.....#####....#
#..................#.....#........#
#...#####...########.....#........#
#..............................O..#
#...............................O.#
#.................................#
###################################

00000000000000000000000000000000000
01111000000000000000000000000000000
01111000000000000000000000000000000
01111000000000000000000000000000000
01111000000000000000000000000000000
00000000000000000000000000000000000
00000000000000000000000000000000000
00000001111000000000000000000000000
00000001111000000000000000000000000
00000001111000000000000000000000000
00000001111000000000000000000000000
00000000000000000000000000000000000
00000000000000000000000000000000000
00000000000000000000000000000000000
00000000000000000000000000000000000
00000000000000002222222220000000000
00000000000000002222222220000000000
00000000000000002222222220000000000
00000000000000002222222220000000000
00000000000000002222222220000000000
00000000000000002222222220000000000
00000000000000002222222220000000000
00000000000000002222222220000000000
00000000000000002222222220000000000
00000000000000000000000000000000000
00000000000000000000000000000000000
00000000000000000000000000000000000
00000000000000000000000000000000000
00000000000000000000000000000000000
00000000000000000000000000000000000
00000000000000000000000000000022220
00000000000000000000000000000022220
00000000000000000000000000000022220
00000000000000000000000000000022220
00000000000000000000000000000000000
