24; 21

#####################
#.........#.........#
#.........#.........#
#..#####..#..#####..#
#..#...#..#..#...#..#
#..#.@.#..#..#.@.#..#
#..#...#..#..#...#..#
#..#...#..#..#...#..#
#..##.##..#..##.##..#
#..#...#..#..#...#..#
#..#...#..#..#...#..#
#..#...#..#..#...#..#
#..#.#.#..#..#.#.#..#
#..#...#..#..#...#..#
#.........#.........#
#.........#.........#
#...###...#...###...#
#.........#.........#
#.........#.........#
#.........#.........#
#.........#.........#
#.O.....O.#.O.....O.#
#.........#.........#
#####################

000000000000000000000
000000000000000000000
000000000000000000000
000000000000000000000
000011100000002220000
000011100000002220000
000011100000002220000
000000000000000000000
000000000000000000000
000000000000000000000
000000000000000000000
000000000000000000000
000000000000000000000
000000000000000000000
000000000000000000000
000000000000000000000
000000000000000000000
000000000000000000000
000000000000000000000
000000000000000000000
022222222201111111110
022222222201111111110
022222222201111111110
000000000000000000000
