13; 17

#################
#.......#.......#
#......O#O......#
#.......#.......#
#......O#O......#
#...#...#...#...#
#...#########...#
#...#...#...#...#
#.......#.......#
#.....@.#.@.....#
#.......#.......#
#.......#.......#
#################

00000000000000000
00000111022200000
00000111022200000
00000111022200000
00000111022200000
00000111022200000
00000000000000000
00000222011100000
00000222011100000
00000222011100000
00000222011100000
00000222011100000
00000000000000000
