19; 17

#################
#.......#.......#
#.......#.......#
#.......#.......#
#...#...#...#...#
#...#...#...#...#
#...#...#...#...#
#.O.#...#...#.O.#
#...#...#...#...#
#####...#...#####
#...#...#...#...#
#.@.#...#...#.@.#
#...#...#...#...#
#...#...#...#...#
#...#...#...#...#
#.......#.......#
#.......#.......#
#.......#.......#
#################

00000000000000000
00000000000000000
00000000000000000
00000000000000000
00000000000000000
00000000000000000
01110000000002220
01110000000002220
01110000000002220
00000000000000000
02220000000001110
02220000000001110
02220000000001110
00000000000000000
00000000000000000
00000000000000000
00000000000000000
00000000000000000
00000000000000000
