35; 35

###################################
#.................................#
#.O...............................#
#..O..............................#
#.................................#
#....###.........#######..........#
#....................#............#
#.........#..........#............#
#.........#.......................#
#........##.......................#
#....#####....#...................#
#....#........#.......#####.......#
#....#......@.#...#...#...........#
#....#........#...#...#...........#
#....#....#####...#...#...........#
#.................#...#...........#
#.................#.........#.....#
#.................#.........#.....#
#.......#####...............#.....#
#.........#.................#.....#
#.........#.............#.........#
#.........#......########.........#
#.....#..........#................#
#.....#..........#.@..............#
#.....#..........#................#
#.....#......#...#.......#####....#
#.....#......#...........#........#
#............#...........#........#
#............#....####...#........#
#............#...........#........#
#...#####.........................#
#..............................O..#
#...............................O.#
#.................................#
###################################

00000000000000000000000000000000000
01111000000000000000000000000000000
01111000000000000000000000000000000
01111000000000000000000000000000000
01111000000000000000000000000000000
00000000000000000000000000000000000
00000000000000000000000000000000000
00000000000000000000000000000000000
00000000000000000000000000000000000
00000000000000000000000000000000000
00000000001111000000000000000000000
00000000001111000000000000000000000
00000000001111000000000000000000000
00000000001111000000000000000000000
00000000000000000000000000000000000
00000000000000000000000000000000000
00000000000000000000000000000000000
00000000000000000000000000000000000
00000000000000000000000000000000000
00000000000000000000000000000000000
00000000000000000000000000000000000
00000000000000000000000000000000000
00000000000000000022220000000000000
00000000000000000022220000000000000
00000000000000000022220000000000000
00000000000000000022220000000000000
00000000000000000000000000000000000
00000000000000000000000000000000000
00000000000000000000000000000000000
00000000000000000000000000000000000
00000000000000000000000000000022220
00000000000000000000000000000022220
00000000000000000000000000000022220
00000000000000000000000000000022220
00000000000000000000000000000000000
